1111111111111111111111111111111111111111111111111111111111111111111111111111111111111111111111111111111
1CCCCCCCCCCCCCCCCCCCCCCCCCCCC00000000000000000000000000000000000000000000000000000000000000000000000001
11111111111111111111111111111111111111111111111111111111111111111111111111111111111111111N0111111111111
10P0000000000000000000000000000000000000001100000000000000000000000000000000000000000000N00N00000000001
100000000000000000000000000000000000000000110000000000000000000000000000000000000000000000NN00000000001
1111111000000000000111111111111111111111111100000000000000000000000000000000000000000000000000000000001
10E000100000000000000000000000000000000CC0110000000000000000000000000000000N000000000000000000000000001
100000100000000000000000000000000000000CC01100000000000000000000000000000000000000000000000000000000001
1000001000000000000000000000000000000000001100000000000000000000000000000000000000000000000000000000001
1000001000000000000000000000000000000000001100000C00000000000000000000000000000000000000000000000000001
1000001000000000000000000000000000000000001100000000000000000000000000C0000000000000000000000C000000001
10000010000000000000000000000000000000000011000000000000000000000000000000000N0000000000000000000000001
1000001CC0000000000000000000000000000000001100000000000000000000000000000000000000000000000000000000001
1000001CC0000000000000000000000000000000001100000000000000000000000000000000000000000000000000000000001
10000011111111111111111111111111111111000011000000C0000000000000N00000000000000000000000000000000000001
100000100000000000000000000000000000000000110000000000000000000000000000000000000N000000000000000000001
1000001000000000000000000000000000000000001100000000000000000000000000000000000000000000000000000000001
1000001000000000000000000000000000000000001100000000000000000000000000000000000000000000000000000000001
1000001000000000000000000000000000000000001100000000000000000000000000000000000000000000000000000000001
10000010000000000000000000000000000000000011000000000000C0000000000000000000000000000000000000000000001
1000001000000000000000000000000000000000001100000000000000000000000000000000000000000000000000000000001
1000001000000000000000000000000000000000001100000000000000000000000000000000000000000000000000C00000001
1000001000000000000000000000000000000000001100000000000000000000000000000000NNNNNNNNNNN0000000000000001
1000001000000000000000000000000000000000001100000000000000000000000000000000000000000000000000000000001
1000001000000000000000000000000000000000001100000000000000000000000000000000000000000000000000000000001
1000001000000000000000000000000000000000001100000000000000000000000000000000000000000000000000000000001
100000N000000000000000000000000000000000001100000000000000000000000000000000000000000000000000000000001
10N1111111111111111111111111111111111110001100000000000000000000000000000000000000000000000000000000001
100000000000000000CC00000000000000000000001100000000000000000000000000000000000000000000000000000000001
1000000000000000000C00000000000000000000001100000000000000000000000000000000000000000000000000000000001
1000000000000000000000000000000000000000001100000000000000000000000000000000000000000000000000000000001
1000000000000000000000000000000000000000001100000000000000000000000000000000000000000000000000000000001
1000000000000000000000000000000000000000001100000000000000000000000000000000000000000000000000000000001
1000000000000000000000000000000000000000001100000000000000000000000000000000000000000000000000000000001
10000000000000000000000000000000000000000011000000000000000000000000000000000000000000000000000C0000001
1000000000000000000000000000000000000000001100000000000000000000000000000000000000000000000000000000001
1000000000000000000000000000000000000000001100000000000000000000000000000000000000000000000000000000001
1000000000000000000000000000000000000000001100000000000000000000000000000000000000000000000000000000001
1000000000000000000000000000000000000000001100000000000000000000000000000000000000000000000000000000001
100000000000000000000000000000000000000000110000000000000000000000000C000000000000000000000000000000001
100000000000000000000000000000000000000000110000000000000C000000000000000000000000000000000000000000001
1111111111111111111111111111111111111111001100000000000000000000000000000000000000000000000000000000001
1000000000000000000000000000000000000000001100000000000000000000000000000000000000000000000000000000001
1000000000000000000000000000000000000000001100000000000000000000000000000000000000000000000000000000001
1000000000000000000000000000000000000000001100000000000000000000000000000000000000000000000000000000001
1011111111111111111111111111111111111111111100000000000000000000000000000000000000000000000000000000001
10000000000000N000000000000000000N000000001100000000000000000000000000000000000000000000000000000000001
1000000N000000N00000000N000000000N000000001100000000000000000000000000000000000000000000000000000000001
1000000N000000000000000N000000000000000000000000000000000C000000000000000000000000000000000000000000001
1111111111111111111111111111111111111111111111111111111111111111111111111111111111111111111111111111111
