1111111111
1000000001
10000P0CE1
1111111011
