11111111
10000001
1P000E01
11111111
