11111111
10000001
1PCE0001
10000211
11111111
