1111111111111111
1C000000N000C001
1NNN0NNCN0NNNNN1
1P0N0NN0N0NEEEE1
1N0N0NN0N0CNNNN1
1N0C0NN00000CEN1
1111111111111111
