1111111111111111
1C0000000000C001
1000000C00000001
1P00000000000001
1000000000C00001
100C00000000CE01
1111111111111111
